00,01,01,02,05,05,05,05,05,05,05,05,05,05,05,05,05,05,05,05,05,05,05,05,05,05,05,05,60,61
10,05,05,12,05,05,05,05,05,05,05,05,05,05,05,05,05,05,05,05,05,05,05,05,05,05,05,05,70,71
10,05,05,12,37,05,05,05,05,05,05,05,05,05,05,05,05,05,05,05,05,05,05,05,05,05,05,05,60,61
10,05,05,12,05,05,05,05,05,05,05,05,05,05,05,05,05,05,05,05,05,05,05,05,05,05,05,05,70,71
10,05,05,12,05,05,05,05,05,05,05,05,05,05,05,05,05,05,05,05,05,05,05,05,05,05,05,05,60,61
10,05,05,12,05,05,05,05,05,05,05,05,05,05,05,05,05,05,05,05,05,05,05,05,05,05,05,05,70,71
10,05,05,12,37,05,05,38,05,05,05,05,05,05,05,05,05,05,05,05,05,05,38,05,05,05,57,05,60,61
10,05,05,12,05,05,30,31,31,31,31,32,05,05,05,05,05,05,05,05,05,30,31,31,31,31,32,05,70,71
10,05,05,12,05,05,05,05,05,05,05,48,05,05,05,05,05,05,05,05,05,05,05,05,05,05,05,05,60,61
10,05,05,12,05,05,05,05,05,05,05,48,05,05,05,36,05,05,46,05,05,05,05,05,05,05,05,05,52,53
10,05,05,12,05,05,05,05,05,05,05,58,05,05,30,31,31,31,32,05,05,05,05,05,05,05,05,05,05,05
10,05,05,12,05,05,05,05,05,05,05,05,05,05,05,05,05,05,05,05,05,05,05,05,05,05,05,05,05,05
10,05,05,12,05,05,05,57,05,05,05,05,05,05,05,56,05,05,05,05,05,57,05,05,05,05,38,05,05,05
10,05,05,12,00,01,01,01,01,01,01,01,01,01,01,01,01,01,01,01,01,01,01,01,01,01,01,01,01,02
10,05,05,12,10,05,05,05,05,05,05,05,05,05,05,05,05,05,05,05,05,05,05,05,05,05,05,05,05,12
10,05,05,12,10,05,05,05,05,05,05,05,05,05,05,05,05,05,05,05,05,05,05,05,05,05,05,05,05,12
20,21,21,22,10,05,05,05,05,05,05,05,05,05,05,05,05,05,05,05,05,05,05,05,05,05,05,05,05,12
